1111111111111111111111111111111
1000001100000000110000000000001
1E0C1000110C1100111111001111111
1111100000110000000000000000001
1000000000M00000001111001111001
10011110000B0000001001001C00001
1001C01111000000001001001111111
1P110000000000000000010000000C1
1111111111111111111111111111111