111111111111111111111111111111111111111111111111111111111111
1P0000000000011110000C0000000M111100000000000000001111111111
1110111111000011111111000110000111111110001111100010000M0001
1000000000011110000000111000000C000000111100000001100MC00001
10000111111100000M000000000000000111100000111111100000MC0001
1000000000000M00C011111001111110000000M000000000C00000000001
100011111111000000000000011111111000000M00111111111111111111
100000C0000000M0000M0000000000001100000000000000C00000000001
111111100001111111111100111111111111111100000111111000000C01
100000000000000000000001100000000000000011100000000000000001
100001111111111100C000111111111000011111111111000000000000M1
1000000C00000000000011111000000000000000M000001111110000M0C1
111111110000111111111111111111111111110000000000000000001111
1000000000000000000000000000000000000000000M0000000000000001
11110000C0000011111M0011111111000111111111100000011111100001
1000000000011110000000000000000B0000000000000000000000000001
100011111111000011111100111111111000000011111111111100000001
10000000000000000000M00000000000100000000000000000000000M011
11110001111110000111111110M0000111000000M0011111111111111111
1000000000000000000000000111000000000C0000000000000000000001
10000001111110000000C0000000111111000011111111000000M0000001
10000000000001111100000M000000000000000000000011111100000001
111111111000000000001111100000111111000111111100000011100001
1C00000000000C0000000000000000000000000000000000000000111001
111000000000001111000011111000011111100011111111111111111111
10000000111100000000000M00C000000000001000000000000000000001
100000000000011111000000000001111111111111111100000M00000001
11100000000000C00001111111110000000111111000001111110000M001
10000000111110000000000000000001111111111100000000000M0MC001
10000000000000000000000C0000000000000000E100000000000M00M001
111111111111111111111111111111111111111111111111111111111111